
NO ./textures/TE_1E.png
SO ./textures/TE_1E.png
WE ./textures/TE_1E.png
EA ./textures/TE_1E.png
DOOR ./textures/DOOR_4A.png

F 128,128,128
C 128,128,128


1161111111111111111181118111811118111181111811111811117114181111171171111
4000010004111111110007000600060001000100010000004000303030303030202020201
40000D000111111118010001000100010001000101900000D000000000000000000000009
4171110001117161116111171661D16116111872666661004000030303030302020202021
6000010000000000010000000000000001310000000013171D48111161411174111861111
1000011110000000010000000000000000D0000000000D00N010000101000100401007001
70000D00D0000000000000000000000001310000000013100600000000000000000000001
1111111111D11111111141111111141111111872666611004000000000111114000000111
1000000001010000000000010090001222922210000000400111160000110000110000001
1001131111D131131D1111100000001200000260000000110D00000000110000110000011
100000000000000D000000010008107200000210000000010110000110000110000110001
1001131D1131311311D111110001311222022211000000800800000110000110000110001
10010010100000001101100D0001311111D116111111112D2111000000110000110000331
10000010D0001000000000010000D0000000000000000000D000000000110000110000331
1171111114111161111119111121316111281117111111111711171111111111111111111
