
NO ./textures/TE_1E.png
SO ./textures/TE_1E.png
WE ./textures/TE_1E.png
EA ./textures/TE_1E.png
DOOR ./textures/DOOR_4A.png

F 128,128,128
C 128,128,128


116111111111111111118111811181111811118111181111181111711118111117117111
40S001000411111111000700060006000100010001000000000000000000000000000001
40000D000111111118010001000100010001000101000000000000000000000000000001
4171110001117161116111171661D1611611111111000000000000000000000000000001
600001000000000001000000000000000131000000000000000000000000000000000001
1000011110000000010000000000000000D0000000000000000000000000000000000001
70000D00D000000000000000000000000131000000000000000000000000000000000001
1111111111D1111111111111111111111111111111111100000000000000000000000001
100000000101000000000001000000000000000000000000000000000000000000000001
1001131111D131131D111110000000000000000000000000000000000000000000000011
100000000000000D00000001000000000000000000000000000000000000000000000001
1001131D1131311311D11111000000000000000000000000000000000000000000000001
100100101000000011011001000000000000000000000000000000000000000000000001
10000010D000100000000001000000000000000000000000000000000000000000000001
117111111411116111111911112111611128111111111111171117111111111111111111
