111111111111111111111111111
100000000000000000000000001
100000000000000000000000001
100000000000000000111111111
100000000000000000000000001
1000000000000000000000000011111111111111111111111
1000000000000000000000000000000000000000000000001
1000000000000000000000000000000000000000000000001
1111111111111111100000000000000011111111111111111
                10000000000000001
111111111111111110000000000000001
100000000000000000000000000000001
100000000000000000000000000000001
111111111111111111111111111111111
