
NO ./textures/north_wall.png


SO ./textures/south_wall.png
WE ./textures/west_wall.png




EA ./textures/east_wall.png

DOOR ./textures/door.png

F 128,128,128



C 128,128,128


111111111111111111111111111
100000000000000000000000001
100000000000000000000000001
100000010000000000111111111
1000000100111D1000000000001
1000000D00W00010000000000011111111111111111111111
1000000101D100D0000000000000000010000000000000001
10000000000000100000000000000000D0000000000000001
1111111111111111100000000000000011111111111111111
                10000000000000001
111111111111111110000000000000001
100000000000000000000000000000001
100000000000000000000000000000001
111111111111111111111111111111111
